##########
#        #
######## #
#        #
# ########
# # ##   #
# #    # #
# ###### #
#        #
##########
