########################################################### #############################################################
#                                                                                                                       #
# #  # # # ## ## ## ##  ### ### ### ###                    ############################################################ #
#    # # #    ## ## ##      ### ### ###                    #                                                            #
# ##   # #       ## ##          ### ###                    # ############################################################
#        #          ##   ####       ###                    #                                                            #
# ###                    #### ####                         ############################################################ #
#          # ## ### #### #### #### ####                    #                                                            #
# ####     # ## ### #### #### #### #### ####               # ############################################################
#                                                          #                                                            #
  ##################################################################################################################### #
#                                                         #                                                           # #
# ## #### ############################################### # ######################################################### # #
# ## # ##                                               # # #                                                         # #
# #  #    ############################################# # # # ######################################################### #
# ####### #                                             # # # #   #   #   #   #   #   #   #   #   #   #   #   #   #   # #
#    #  # # ############################################# # # # # # # # # # # # # # # # # # # # # # # # # # # # # # # # #
# ## # ## #                                                 # # # # # # # # # # # # # # # # # # # # # # # # # # # # # # #
# #### ## ################################################# # # # # # # # # # # # # # # # # # # # # # # # # # # # # # # #
#                                                           #   #   #   #   #   #   #   #   #   #   #   #   #   #   #   #
########################################################### #############################################################
