########################################
E                                      #
###################################### #
#          #########                 # #
# ########         # ############### # #
#          ####### #       ####      # #
############       # ### #      ###### #
#            ### ###    ## ######    # #
# ############     # ##           ## # #
#          #   ###   ## ######### ## # #
########## # #     # ## #######   ## # #
#        # # ### ### ##         # ## # #
# ###### # #     #      ######### ## # #
# # #### # ####### # #### ####### ## # #
# #      #         # #    # ##### ## # #
# ### ## ########### # ## ####### ## # #
#     #              #               # #
# #################################### #
#                                      #
########################################
