########################################
                                       #
###################################### #
#          #########                 # #
# ########         #   #             # #
#          ####### #         ##      # #
############       #     #           # #
#            ### ###     # ######### # #
# ############     # ##              # #
#          #         ##  ######      # #
########## # #     # ##  ######      # #
#        # # ### ###                 # #
#  ####  # #     #        #######    # #
#  # ##  # ####### #      #######    # #
#  #     #         #      # #####    # #
#  ## #  ###########      #######    # #
#     #                              # #
# #################################### #
#                                      #
########################################
