####################################### ########################################
#                                                                              #
# ############################################################################ #
#          #########                                                         # #
# ########         #   #              ##                                     # #
#          ####### #         ##       ##                                     # #
############       #     #            ##           # ## #                      #
#            ### ###     # #########  ##        ####### #                      #
# ############     # ##               ## #         ## #    #                   #
           #         ##  ######       ########        ##                       #  
########## # #     # ##  ######       # ##        ##   #                       #
#        # # ### ###                  ##                #                      #
#  ####  # #     #        #######     ##               #                       #
#  # ##  # ####### #      #######                                            # #
#  #     #         #      # #####                                            # #
#  ## #  ###########      #######                                            # #
#     #                                                                      # #
# ############################################################################ #
#                                                                              #
####################################### ########################################
